'	っ
-	ー
;	あん
[	「
]	」
`,	‥
`/	・
`;	;
`a	ぁ
`b	←
`ca	ヵ
`ce	ヶ
`e	ぇ
`f	→
`i	ぃ
`n	↓
`o	ぉ
`p	↑
`u	ぅ
`va	ゃ
`vh	ゅ
`vn	ょ
`vo	ょ
`vs	ゃ
`vu	ゅ
`wa	ゎ
`we	ゑ
`wi	ゐ
`{	『
`}	』
a	あ
b'	ばい
b,	ぼう
b.	べい
b;	ばん
ba	ば
bb'	びゃっ
bb,	びょっ
bb.	びぇっ
bb;	ばつ
bba	ばっ
bbe	べっ
bbi	びっ
bbj	べつ
bbk	ぶつ
bbo	ぼっ
bbp	びゅっ
bbq	ぼつ
bbu	ぶっ
bbx	びつ
bby	びぃっ
be	べ
bi	び
bj	べん
bk	ぶん
bo	ぼ
bp	ぶう
bq	ぼん
bu	ぶ
bv'	びゃい
bv,	びょう
bv.	びぇい
bv;	びゃん
bva	びゃ
bve	びぇ
bvi	びぃ
bvj	びぇん
bvk	びゅん
bvm	びゅく
bvo	びょ
bvp	びゅう
bvq	びょん
bvu	びゅ
bvv	びょく
bvw	びゅつ
bvx	びぃん
bvy	びゅい
bvz	びゃく
bw	びゅう
bx	びん
by	ぶい
bz	びょう
c'	かい
c,	こう
c.	けい
c;	かん
ca	か
cc	きゅう
ce	け
cf'	きゃっ
cf,	きょっ
cf.	きぇっ
cf;	かつ
cfa	かっ
cfe	けっ
cfi	きっ
cfj	けつ
cfk	くつ
cfo	こっ
cfp	きゅっ
cfq	こつ
cfu	くっ
cfx	きつ
cfy	きぃっ
cg'	きゃい
cg,	きょう
cg.	きぇい
cg;	きゃん
cga	きゃ
cgc	きゅつ
cge	きぇ
cgg	きゅく
cgi	きぃ
cgj	きぇん
cgk	きゅん
cgl	きゃく
cgo	きょ
cgp	きゅう
cgq	きょん
cgr	きょく
cgu	きゅ
cgx	きぃん
cgy	きゅい
ci	き
cj	けん
ck	くん
cl	きょう
co	こ
cp	くう
cq	こん
cu	く
cx	きん
cy	くい
d'	だい
d,	どう
d.	でい
d;	だん
da	だ
dd'	でゃっ
dd,	でょっ
dd.	でぇっ
dd;	だつ
dda	だっ
dde	でっ
ddi	ぢっ
ddj	でつ
ddk	づつ
ddo	どっ
ddp	でゅっ
ddq	どつ
ddu	づっ
ddx	ぢつ
ddy	でぃっ
de	で
dh'	でゃい
dh,	でょう
dh.	でぇい
dh;	でゃん
dha	でゃ
dhe	でぇ
dhi	でぃ
dhj	でぇん
dhk	でゅん
dho	でょ
dhp	でゅう
dhq	でょん
dhu	でゅ
dhx	でぃん
dhy	でゅい
di	ぢ
dj	でん
dk	づん
dn'	ぢゃい
dn,	ぢょう
dn.	ぢぇい
dn;	ぢゃん
dna	ぢゃ
dne	ぢぇ
dnh	ぢゅく
dni	ぢぃ
dnj	ぢぇん
dnk	ぢゅん
dnn	ぢょく
dno	ぢょ
dnp	ぢゅう
dnq	ぢょん
dns	ぢゃく
dnt	ぢゅつ
dnu	ぢゅ
dnx	ぢぃん
dny	ぢゅい
do	ど
dp	づう
dq	どん
du	づ
dx	ぢん
dy	づい
e	え
f'	ぱい
f,	ぽう
f.	ぺい
f;	ぱん
fa	ぱ
fc	ぴゅう
fe	ぺ
ff'	ぴゃっ
ff,	ぴょっ
ff.	ぴぇっ
ff;	ぱつ
ffa	ぱっ
ffe	ぺっ
ffi	ぴっ
ffj	ぺつ
ffk	ぷつ
ffo	ぽっ
ffp	ぴゅっ
ffq	ぽつ
ffu	ぷっ
ffx	ぴつ
ffy	ぴぃっ
fi	ぴ
fj	ぺん
fk	ぷん
fl	ぴょう
fo	ぽ
fp	ぷう
fq	ぽん
fr'	ぴゃい
fr,	ぴょう
fr.	ぴぇい
fr;	ぴゃん
fra	ぴゃ
frc	ぴゅつ
fre	ぴぇ
frg	ぴゅく
fri	ぴぃ
frj	ぴぇん
frk	ぴゅん
frl	ぴゃく
fro	ぴょ
frp	ぴゅう
frq	ぴょん
frr	ぴょく
fru	ぴゅ
frx	ぴぃん
fry	ぴゅい
fu	ぷ
fx	ぴん
fy	ぷい
g'	がい
g,	ごう
g.	げい
g;	がん
ga	が
gc	ぎゅう
ge	げ
gf'	ぎゃっ
gf,	ぎょっ
gf.	ぎぇっ
gf;	がつ
gfa	がっ
gfe	げっ
gfi	ぎっ
gfj	げつ
gfk	ぐつ
gfo	ごっ
gfp	ぎゅっ
gfq	ごつ
gfu	ぐっ
gfx	ぎつ
gfy	ぎぃっ
gi	ぎ
gj	げん
gk	ぐん
gl	ぎょう
go	ご
gp	ぐう
gq	ごん
gr'	ぎゃい
gr,	ぎょう
gr.	ぎぇい
gr;	ぎゃん
gra	ぎゃ
grc	ぎゅつ
gre	ぎぇ
grg	ぎゅく
gri	ぎぃ
grj	ぎぇん
grk	ぎゅん
grl	ぎゃく
gro	ぎょ
grp	ぎゅう
grq	ぎょん
grr	ぎょく
gru	ぎゅ
grx	ぎぃん
gry	ぎゅい
gu	ぐ
gx	ぎん
gy	ぐい
h'	はい
h,	ほう
h.	へい
h;	はん
ha	は
hd'	ひゃっ
hd,	ひょっ
hd.	ひぇっ
hd;	はつ
hda	はっ
hde	へっ
hdi	ひっ
hdj	へつ
hdk	ふつ
hdo	ほっ
hdp	ひゅっ
hdq	ほつ
hdu	ふっ
hdx	ひつ
hdy	ひぃっ
he	へ
hh'	ふぁい
hh,	ふぉう
hh.	ふぇい
hh;	ふぁん
hha	ふぁ
hhe	ふぇ
hhi	ふぃ
hhj	ふぇん
hhk	ふぅん
hhna	ふゃ
hhno	ふょ
hhnu	ふゅ
hho	ふぉ
hhp	ふぅう
hhq	ふぉん
hhu	ふぅ
hhx	ふぃん
hhy	ふぅい
hi	ひ
hj	へん
hk	ふん
hn'	ひゃい
hn,	ひょう
hn.	ひぇい
hn;	ひゃん
hna	ひゃ
hne	ひぇ
hnh	ひゅく
hni	ひぃ
hnj	ひぇん
hnk	ひゅん
hnn	ひょく
hno	ひょ
hnp	ひゅう
hnq	ひょん
hns	ひゃく
hnt	ひゅつ
hnu	ひゅ
hnx	ひぃん
hny	ひゅい
ho	ほ
hp	ふう
hq	ほん
hs	ひょう
ht	ひゅう
hu	ふ
hx	ひん
hy	ふい
i	い
j	えん
k	うん
la	ぁ
le	ぇ
li	ぃ
lo	ぉ
lu	ぅ
lva	ゃ
lvo	ょ
lvu	ゅ
lwa	ゎ
m'	まい
m,	もう
m.	めい
m;	まん
ma	ま
mb'	みゃっ
mb,	みょっ
mb.	みぇっ
mb;	まつ
mba	まっ
mbe	めっ
mbi	みっ
mbj	めつ
mbk	むつ
mbo	もっ
mbp	みゅっ
mbq	もつ
mbu	むっ
mbx	みつ
mby	みぃっ
me	め
mi	み
mj	めん
mk	むん
mo	も
mp	むう
mq	もん
mu	む
mv'	みゃい
mv,	みょう
mv.	みぇい
mv;	みゃん
mva	みゃ
mve	みぇ
mvi	みぃ
mvj	みぇん
mvk	みゅん
mvm	みゅく
mvo	みょ
mvp	みゅう
mvq	みょん
mvu	みゅ
mvv	みょく
mvw	みゅつ
mvx	みぃん
mvy	みゅい
mvz	みゃく
mw	みゅう
mx	みん
my	むい
mz	みょう
n	ん
n'	ない
n,	のう
n.	ねい
n;	なん
na	な
nd'	にゃっ
nd,	にょっ
nd.	にぇっ
nd;	なつ
nda	なっ
nde	ねっ
ndi	にっ
ndj	ねつ
ndk	ぬつ
ndo	のっ
ndp	にゅっ
ndq	のつ
ndu	ぬっ
ndx	につ
ndy	にぃっ
ne	ね
nh'	にゃい
nh,	にょう
nh.	にぇい
nh;	にゃん
nha	にゃ
nhe	にぇ
nhh	にゅく
nhi	にぃ
nhj	にぇん
nhk	にゅん
nhn	にょく
nho	にょ
nhp	にゅう
nhq	にょん
nhs	にゃく
nht	にゅつ
nhu	にゅ
nhx	にぃん
nhy	にゅい
ni	に
nj	ねん
nk	ぬん
nn	ん
no	の
np	ぬう
nq	のん
ns	にょう
nt	にゅう
nu	ぬ
nx	にん
ny	ぬい
o	お
p	…
q	おん
r'	らい
r,	ろう
r.	れい
r;	らん
ra	ら
rc	りゅう
re	れ
rf'	りゃっ
rf,	りょっ
rf.	りぇっ
rf;	らつ
rfa	らっ
rfe	れっ
rfi	りっ
rfj	れつ
rfk	るつ
rfo	ろっ
rfp	りゅっ
rfq	ろつ
rfu	るっ
rfx	りつ
rfy	りぃっ
rg'	りゃい
rg,	りょう
rg.	りぇい
rg;	りゃん
rga	りゃ
rgc	りゅつ
rge	りぇ
rgg	りゅく
rgi	りぃ
rgj	りぇん
rgk	りゅん
rgl	りゃく
rgo	りょ
rgp	りゅう
rgq	りょん
rgr	りょく
rgu	りゅ
rgx	りぃん
rgy	りゅい
ri	り
rj	れん
rk	るん
rl	りょう
ro	ろ
rp	るう
rq	ろん
ru	る
rx	りん
ry	るい
s'	さい
s,	そう
s.	せい
s;	さん
sa	さ
sd'	しゃっ
sd,	しょっ
sd.	しぇっ
sd;	さつ
sda	さっ
sde	せっ
sdi	しっ
sdj	せつ
sdk	すつ
sdo	そっ
sdp	しゅっ
sdq	そつ
sdu	すっ
sdx	しつ
sdy	しぃっ
se	せ
sh'	しゃい
sh,	しょう
sh.	しぇい
sh;	しゃん
sha	しゃ
she	しぇ
shh	しゅく
shi	しぃ
shj	しぇん
shk	しゅん
shn	しょく
sho	しょ
shp	しゅう
shq	しょん
shs	しゃく
sht	しゅつ
shu	しゅ
shx	しぃん
shy	しゅい
si	し
sj	せん
sk	すん
so	そ
sp	すう
sq	そん
ss	しょう
st	しゅう
su	す
sx	しん
sy	すい
t'	たい
t,	とう
t.	てい
t;	たん
ta	た
td'	ちゃっ
td,	ちょっ
td.	ちぇっ
td;	たつ
tda	たっ
tde	てっ
tdi	ちっ
tdj	てつ
tdk	つつ
tdo	とっ
tdp	ちゅっ
tdq	とつ
tdu	つっ
tdx	ちつ
tdy	ちぃっ
te	て
th'	ちゃい
th,	ちょう
th.	ちぇい
th;	ちゃん
tha	ちゃ
the	ちぇ
thh	ちゅく
thi	ちぃ
thj	ちぇん
thk	ちゅん
thn	ちょく
tho	ちょ
thp	ちゅう
thq	ちょん
ths	ちゃく
tht	ちゅつ
thu	ちゅ
thx	ちぃん
thy	ちゅい
ti	ち
tj	てん
tk	つん
tn'	てゃい
tn,	てょう
tn.	てぇい
tn;	てゃん
tna	てゃ
tne	てぇ
tni	てぃ
tnj	てぇん
tnk	てゅん
tno	てょ
tnp	てゅう
tnq	てょん
tnu	てゅ
tnx	てぃん
tny	てゅい
to	と
tp	つう
tq	とん
ts	ちょう
tt	ちゅう
tu	つ
tx	ちん
ty	つい
u	う
v'	やい
v,	よう
v;	やん
va	や
vb'	ヴゃっ
vb,	ヴょっ
vb.	ヴぇっ
vb;	やつ
vba	やっ
vbk	ゆつ
vbo	よっ
vbp	ヴゅっ
vbq	よつ
vbu	ゆっ
vby	ヴぃっ
vk	ゆん
vo	よ
vp	ゆう
vq	よん
vu	ゆ
vv'	ヴぁい
vv,	ヴぉう
vv.	ヴぇい
vv;	ヴぁん
vva	ヴぁ
vve	ヴぇ
vvi	ヴぃ
vvj	ヴぇん
vvk	ヴぅん
vvm'	ヴゃい
vvm,	ヴょう
vvm;	ヴゃん
vvma	ヴゃ 
vvmk	ヴゅん
vvmo	ヴょ
vvmp	ヴゅう
vvmq	ヴょん
vvmu	ヴゅ
vvmy	ヴゅい
vvo	ヴぉ
vvp	ヴぅう
vvq	ヴぉん
vvu	ヴ
vvx	ヴぃん
vvy	ヴぅい
vy	ゆい
w'	わい
w,	をう
w.	ゑい
w;	わん
wa	わ
wb'	うゃっ
wb,	うょっ
wb.	うぇっ
wb;	わつ
wba	わっ
wbe	ゑっ
wbi	ゐっ
wbj	ゑつ
wbo	をっ
wbp	うゅっ
wbq	をつ
wbx	ゐつ
wby	うぃっ
we	ゑ
wi	ゐ
wj	ゑん
wo	を
wq	をん
ww'	うぁい
ww,	うぉう
ww.	うぇい
ww;	うぁん
wwa	うぁ
wwe	うぇ
wwi	うぃ
wwj	うぇん
wwk	うぅん
wwo	うぉ
wwp	うぅう
wwq	うぉん
wwu	うぅ
wwx	うぃん
wwy	うぅい
wx	ゐん
x	いん
z'	ざい
z,	ぞう
z.	ぜい
z;	ざん
za	ざ
zb'	じゃっ
zb,	じょっ
zb.	じぇっ
zb;	ざつ
zba	ざっ
zbe	ぜっ
zbi	じっ
zbj	ぜつ
zbk	ずつ
zbo	ぞっ
zbp	じゅっ
zbq	ぞつ
zbu	ずっ
zbx	じつ
zby	じぃっ
ze	ぜ
zi	じ
zj	ぜん
zk	ずん
zm'	じゃい
zm,	じょう
zm.	じぇい
zm;	じゃん
zma	じゃ
zme	じぇ
zmi	じぃ
zmj	じぇん
zmk	じゅん
zmm	じゅく
zmo	じょ
zmp	じゅう
zmq	じょん
zmu	じゅ
zmv	じょく
zmw	じゅつ
zmx	じぃん
zmy	じゅい
zmz	じゃく
zo	ぞ
zp	ずう
zq	ぞん
zu	ず
zw	じゅう
zx	じん
zy	ずい
zz	じょう
